
{
    "0": "$",
    "1": "@",
    "2": "B",
    "3": "%",
    "4": "8",
    "5": "&",
    "6": "W",
    "7": "M",
    "8": "#",
    "9": "*",
    "10": "o",
    "11": "a",
    "12": "h",
    "13": "k",
    "14": "b",
    "15": "d",
    "16": "p",
    "17": "q",
    "18": "w",
    "19": "m",
    "20": "Z",
    "21": "O",
    "22": "0",
    "23": "Q",
    "24": "L",
    "25": "C",
    "26": "J",
    "27": "U",
    "28": "Y",
    "29": "X",
    "30": "z",
    "31": "c",
    "32": "v",
    "33": "u",
    "34": "n",
    "35": "x",
    "36": "r",
    "37": "j",
    "38": "f",
    "39": "t",
    "40": "/",
    "41": "\\",
    "42": "|",
    "43": "(",
    "44": ")",
    "45": "1",
    "46": "{",
    "47": "}",
    "48": "[",
    "49": "]",
    "50": "?",
    "51": "-",
    "52": "_",
    "53": "+",
    "54": "~",
    "55": "<",
    "56": ">",
    "57": "i",
    "58": "!",
    "59": "l",
    "60": "I",
    "61": ";",
    "62": ":",
    "63": ",",
    "64": "\"",
    "65": "^",
    "66": "`",
    "67": "'",
    "68": ".",
    "69": " ",
    "70": " "
}
